#######
#X#   #
# # #O##
#      #
# # ## #
#  Y   #
########
