#######
#X#   #
#X# #O##
#    O #
# # ## #
#  Y   #
########
